@TITLE 丛林哨所
@ENEMIES 12
#####################
#P..#.....#.....E...#
#.##.#.##.#.##.#.##.#
#..................E#
#.####...####...#####
#...................#
#E.................E#
#...................#
#.####...####...#####
#...................#
#.##.#.##.#.##.#.##.#
#...#.....#.....B...#
#####################
