@TITLE 钢桥要塞
@ENEMIES 14
#####################
#P...E.......E....E.#
#.@.@...@...@...@...#
#...................#
#...#####...#####...#
#...#...#...#...#...#
#E..#...B...#...#..E#
#...#...#...#...#...#
#...#####...#####...#
#...................#
#.@.@...@...@...@...#
#...................#
#.##.#.##.#.##.#.##.#
#####################
