@TITLE 孤岛阵地
@ENEMIES 15
#####################
#PE.......E.......E.#
#.###.....###.....###
#.#.#.....#.#.....#.#
#...................#
#.....###...###.....#
#.....#.#...#.#.....#
#E....#.#B.#.#.....E#
#.....#.#...#.#.....#
#.....###...###.....#
#...................#
#.#.#.....#.#.....#.#
#.###.....###.....###
#####################
