@TITLE 地道网络
@ENEMIES 16
#####################
#P......E.....E.....#
######........#####.#
##...#........#...#.#
##.@.#....E...@.@.#.#
##...#........#...#.#
######...B...######.#
#...................#
#.#####.....#####...#
#.#...#.....#...#...#
#.#.@.#..E...@.@.#..#
#.#...#.....#...#...#
#.#####.....#####..E#
#####################
