@TITLE 决战
@ENEMIES 22
#####################
#P...E...###...E...E#
#.###.#.#..@#.#.###.#
#...#.#.#...#.#.#...#
####.#.#.#####.#.#.##
#...#.....B.....#...#
#E.##.###.@.###.##.E#
#...#....@.@....#...#
####.#.#.#####.#.#.##
#...#.#.#...#.#.#...#
#.###.#.#..@#.#.###.#
#...E.....###.....E.#
#####################
