@TITLE 峡谷狭道
@ENEMIES 14
#####################
#P.#...E.....E...#.E#
#..#..#####..#..#...#
#......#...#......E.#
#.####.#.@.#.####...#
#......#...#........#
#E..@...........@..E#
#......#...#........#
#.####.#.@.#.####...#
#......#...#......E.#
#..#..#####..#..#...#
#..#.....B.......#..#
#####################
