@TITLE 钢铁迷宫
@ENEMIES 16
#####################
#P...E...###...E...E#
#.###.#.#..@#.#.###.#
#...#.#.#...#.#.#...#
###.#.#.#####.#.#.###
#...#.....B.....#...#
#E.##.###.@.###.##.E#
#...#....@.@....#...#
###.#.#.#####.#.#.###
#...#.#.#...#.#.#...#
#.###.#.#..@#.#.###.#
#...E.....###.....E.#
#####################
