@TITLE 沼泽伏击
@ENEMIES 14
#####################
#P......E.....E.....#
#..###...###...###..#
#..#.#...#.#...#.#..#
#..................E#
#...###.......###...#
#...#.........#.....#
#E......B.........E.#
#...#.........#.....#
#...###.......###...#
#...................#
#..#.#...#.#...#.#..#
#..###...###...###..#
#####################
