@TITLE 十字街区
@ENEMIES 15
#####################
#P.......E........E.#
#...#.......#.......#
#...#.#####.#.......#
#...#.#...#.#....E..#
#...#.#.@.#.#.......#
#E..#.#...#.#.....E.#
#####.#B.#.#.########
#...#.#...#.#.......#
#...#.#.@.#.#.......#
#...#.#...#.#....E..#
#...#.#####.#.......#
#...#.......#.......#
#####################
