@TITLE 回旋长廊
@ENEMIES 16
#####################
#PE.................#
#.#################.#
#.#...............#.#
#.#.#############.#.#
#.#.#...........#.#.#
#.#.#..#######..#.#.#
#.#.#..#...B.#..#.#.#
#.#.#..#.E.#.#..#.#.#
#.#.#..#####.#..#.#.#
#.#.#.......#...#.#.#
#.#.........#...#E#.#
#.#############...#.#
#####################
