@TITLE 环形工事
@ENEMIES 18
#####################
#P...E....E....E....#
#.#################.#
#.#...............#.#
#.#.#####...#####.#.#
#.#.#...#...#...#.#.#
#.#.#.@.#.@.#.@.#.#.#
#E#.#...#...#...#.#E#
#.#.#.@.#.@.#.@.#.#.#
#.#.#...#...#...#.#.#
#.#.#####...#####.#.#
#.#.......B.......#.#
#.#################.#
#####################
